.                                                                                                                                                                                                                                              .
.                                                                                                                                                                                                                                              .
.                                                                                                                                                                                                                                              .
.                                                                                                                                                                                                                                              .
.                                                                                                                                                                                                                                              .
.                                                                                                                                                                                                                                              .
.                                                                                                                                                                                                                                              .
.                                                                                                                                                                                                                                              .
.                                                                                                                                                                                                                                              .
.                                                                                                                                                                                                                                              .
.                                                                                                                                                                                                                                              .
.                 ==========================                            ====================================================================================================================================================================== .
.                                                                                                                                                                                                                                              .
.                                                                                                                                                                                                                                              .
.                                                                                                                                                                                                                                              .
.                                                                                                                                                                                                                                              .
.                                                                                                                                                                                                                                              .
.                                                                                                                                                                                                                                              .
.                                                                                                                                                                                                                                              .
.                                                                                                                                                                                                                                              .
.                                                                                                                                                                                                                                              .
.                                                                                                                                                                                                                                              .
.                                                                                                                                                                                                                                              .
.   ====================================                                             ========================================================================================================================================================= .
.                                                                                                                                                                                                                                              .
.                                                                                                                                                                                                                                              .
.                                                                                                                                                                                                                                              .
.                                                                                                                                                                                                                                              .
.                                                                                                                                                                                                                                              .
.                                                                                                                                                                                                                                              .
.                                                                                                                                                                                                                                              .
.                                                                                                                                                                                                                                              .
.                                                                                                                                                                                                                                              .
================================================================================================================================================================================================================================================
################################################################################################################################################################################################################################################
################################################################################################################################################################################################################################################
------------------------------------------------------------------------------------------------------------------------------------------------------------------------------------------------------------------------------------------------
