.                                                                                                                      .
.                                                                                                                      .
.                                                                                                                      .
.                                                                                                                      .
.                                                                                                                      .
.                                                                                                                      .
.                                                                                                                      .
.                                                                                                                      .
.                                                                                                                      .
.                                                                                                                      .
.                                                                                                                      .
.          ==========================                                   ============================================== .
.                                                                                                                      .
.                                                                                                                      .
.                                                                                                                      .
.                                                                                                                      .
.                                                                                                                      .
.                                                                                                                      .
.                                                                                                                      .
.                                                                                                                      .
.                                                                                                                      .
.                                                                                                                      .
.                                                                                                                      .
.   ====================================                                         ===================================== .
.                                                                                                                      .
.                                                                                                                      .
.                                                                                                                      .
.                                                                                                                      .
.                                                                                                                      .
.                                                                                                                      .
.                                                                                                                      .
.                                                                                                                      .
.                                                                                                                      .
========================================================================================================================
########################################################################################################################
########################################################################################################################
------------------------------------------------------------------------------------------------------------------------
